-------------------
---------S---------
--TTT---TTT---TTT--
--TTTTTTTTTTTTTTT--
--TTT--TTTTT--TTT--
-------------------
