---------S---------
--TTT---TTT---TTT--
--TOTTTTTTTTTTTOT--
--TTT--TTTTT--TTT--
---T-----T-----T---
---T----TTT----T---
---TTTTTTMTTTTTT---
---T----TTT----T---
---T-----T-----T---
--TTT---TTT---TTT--
--TMTTTTTOTTTTTMT--
--TTT--TTTTT--TTT--
---T-----T-----T---
---T----TTT----T---
---TTTTTTMTTTTTT---
---T----TTT----T---
---T-----T-----T---
--TTT---TTT---TTT--
--TOTTTTTTTTTTTOT--
--TTT--TTTTT--TTT--
---------S---------
