---------S---------
--TTT---TTT---TTT--
--TNTTTTTTTTTTTNT--
--TTT--TTTTT--TTT--
---T-----T-----T---
---T----TTT----T---
---TTTTTTMTTTTTT---
---T----TTT----T---
---T-----T-----T---
--TTT---TTT---TTT--
--TMTTTTTNTTTTTMT--
--TTT--TTTTT--TTT--
---T-----T-----T---
---T----TTT----T---
---TTTTTTMTTTTTT---
---T----TTT----T---
---T-----T-----T---
--TTT---TTT---TTT--
--TNTTTTTTTTTTTNT--
--TTT--TTTTT--TTT--
---------S---------
