-------------------
---------S---------
--TTT----T----TTT--
--TOTTTTTTTTTTTOT--
--TTT---TTT---TTT--
---T-----T-----T---
---T----TTT----T---
---TTTTTTMTTTTTT---
---T----TTT----T---
---T-----T-----T---
--TTT--TTTTT--TTT--
--TMTTTTTOTTTTTMT--
--TTT--TTTTT--TTT--
---T-----T-----T---
---T----TTT----T---
---TTTTTTMTTTTTT---
---T----TTT----T---
---T-----T-----T---
--TTT---TTT---TTT--
--TOTTTTTTTTTTTOT--
--TTT----T----TTT--
---------S---------
-------------------
